00000000000001
00000000000011
11111111111111
11111111111110
11111111111110
01111111111110
00111111111110
00111111111100
00000111100110
00000011000100
00000000000000